1111111111111
10010000000C1
1000011111001
1P0010000E001
1111111111111