111111111111111111111111111111
1C01C0010000N000C00000000000C1
1C111001000000C1C0001111111111
100N0001C010011111000000000011
100000010010000C00000000000001
100000010C10000000111110000001
100100011110000000100100000001
1N0100000000000001100111110001
1001000000N0010011110000000001
100100000000010011111100000001
1001001110000100CC000111111001
1001C00C1011100001100000001001
100111111000100001000000001001
11C100110000CC0001000111111001
111100110000100001000001000001
1C0100000000100P01000001000001
100100001111111111111111100001
100100000100000100000000000001
10000011000000110000C000C00001
10011111001100CC111111111110C1
1C000C1100110000N0000C000000E1
1C01C0010000N000C00000000000C1
1C111001000000C1C0001111111111
111111111111111111111111111111